R 1920 1024
NO ./textures/mossy.png
SO ./textures/purplestone.png
WE ./textures/redbrick.png
EA ./textures/greystone.png
S  ./textures/barrel.png
F 6,120,2
C 0,141,255

11111111111111
10000000000001
10000000000001
10000000000001
100000W0000001
10000000000001
10000000000001
10000000000001
10000000000001
11111111111111