R 1920 1080
NO ./textures/mossy.png
SO ./textures/purplestone.png
WE ./textures/redbrick.png
EA ./textures/greystone.png
S  ./textures/barrel.png
F 6,120,2
C 0,141,255

11111111111111
10000000000001
10000000000001
10000000020001
100000E0020001
10000000000001
10002220000001
10002000000001
10002000000001
11111111111111