R 1920    1080
NO ./textures/mossy.png   
SO ./textures/purplestone.png
WE ./textures/redbrick.png
EA ./textures/greystone.png
S  ./textures/barrel.png
F 6,120,2
C 1,141,255

1111111
1000001
1000001
100W001
1000001
1000001
1111111