R 150    1080
NO ./textures/mossy.png   
SO ./textures/purplestone.png
WE ./textures/redbrick.png
EA ./textures/greystone.png


S  ./textures/efarin.png
F 6,120,2
C 1,141,255

11111111111111
10000000000001
10000000200001
100W0020000001
10000000200001
10000000000001
11111111111111